0000000000000000
1111000000001111
0011333333331100
1011331111331101
0011332222331100
1100444444440011
0000221112220000
0002200110022000
0002200110022000
0011111111111000
0011112221111000
1330002220002211
1333333333333311
0333311111333300
0010011111000100
0210011611000100