1111110001111110
1000010001000010
1111110001000010
0000010001000010
1111110001111110
0000002220000000
0000002220000000
2211000000011222
0000110001100000
1100111111100110
1100110001100110
1122110001122110
1122000000022110
1100011111000110
1100011111000110
2200011611000220