0000000000000000
0000333223330000
3400220002200043
0402222022220040
1402222022220041
1400223332200041
1400033333000141
0000000000000000
2100223332200013
1402222022220041
1402222022220041
1400220002200041
1400000000000041
1100011111000011
1110011111000111
1111011611001111