0000000000000000
1144002200033333
1144002200033333
0000000000000000
0001111111111101
3301100022001101
3301122222221104
3001100022001104
3001102200221103
0331120000021103
0331111111111101
0000000000000201
2022000000000211
2022211111002212
1000211111001112
1000011611002222