0000000000000000
0022001001100000
1111111222220133
1122000000002011
1000111111112000
1002033333333000
1002003333333222
1001000000000222
1002000000000101
1004444224444401
0000000000001011
0233333333322001
1232333333332002
1032311111032000
4233011111032223
1111011611003333