0000000000000000
0022002200220022
3322332233223322
0000000000000000
1011101001001111
1010101001001001
1001001001001001
1010001111101001
1011100001001111
3333333333333333
1100333333330200
0000222222220000
1100000000000200
1100011111000200
2200011111000222
1100011611000222