0000000000000000
1001110011100111
1001110011100111
0220003300033000
0220033333333330
0220011114444330
0002211114444330
2222233332233111
2223333332233111
3333332220033111
3330001110033111
3330001110000111
3330000000001111
3330011111001111
3330011111001122
3330011611000022