0000000000000000
0003300110033000
0330011001100330
0330011001100330
3001100220011003
3001100220011003
0330011001100330
0330011001100330
0003300110033000
0003300110033000
0000033003300000
1000033003300011
1001100000010011
0110011111001100
0110011111001100
0200011611002200