0000000000000000
1111111110033111
0000033000044111
1113333000044111
1110011221122333
1110011221122333
1114444444444441
1114444444444441
1110001100011111
1110003322311111
1112203333333110
1112200000000110
1110000000000120
0110011111000120
2110011111000110
2110011611000112