0000000000000000
0011334444331100
0011333333331100
3333110000110020
3333110000110020
4433002222003344
4433002222003344
0000110000110000
0000110000110000
0011111111111100
0000111441110000
0011111111111100
0011100000011100
0110011211001110
0220011111000111
2200011611000011