0002001001002000
1111101111011111
0111111111111110
1110111011110411
1121111121114441
1111111111444411
0011111111111110
1001011101111010
0011111111111110
1121101211012111
4144441111111111
1144011101110111
1444412221111111
1333112221101133
0333011111000000
0333011611000433