0011110011221100
0044440011221100
0044440000000044
0000221122000044
1111111122000011
1111000000000011
1111221111111022
1111221111111022
0000111112222011
0022111112222011
0000121112200011
0000122222200011
0022000000000022
0022011111000022
3333011111003300
3333011611003300