0022000000011000
0022001110011000
0003301110330022
0003300000330033
4400220001100033
4400220001103311
0000011111003311
0000011011001133
1133022011001133
1133022011003333
2211011011003333
2211011111001133
1100110000004444
1110011111004444
2210011111011111
2210011611011111