0000444400000000
0000444401100333
0011110001100333
0011110002202211
0022440002204411
0022440221104411
0011110221101111
2200114444441100
1100114444441111
1100111111113322
3311000000113322
3300111100002233
3311000000002233
1111011111001122
3311011111001122
3311011611000011