0011000011000000
0011111111113311
3333333311003300
3333333311113300
0002233311003311
0002233211113311
3333333211003300
3333333233223300
0001111331110000
0001100331000011
0001111111110011
0001111111110011
0110000000000011
0110011111000011
0220011111000011
0220011611000011