1100002233333333
1111112233333333
1111112233333333
1100002233333333
0000220000000000
0000221111111111
0000220110110110
1100221111111111
1100000000000000
1122333333004444
1122333333004444
1122333330001111
0200000000001111
0200011111001111
1100011111001221
1100011611001221