0000000000000000
1100112200011111
1100110000022111
1111110000022111
1111333332211111
1111333332211111
2233110001101100
2233110001104400
2200110001104400
2200111111101100
1100111111101122
1100111111100000
4000000000000000
4000011111001100
0110011111001111
0110012621001111