0000000000000000
1111111111111111
0000001110000000
0044331113322000
1044331113322222
1044001110000001
1044001110000001
1033331113311001
1033331113311221
1000001110044444
1122111110044444
1122111111110011
1100001110000011
2200011111000011
2200011111020011
1100011611020011