1100224411002200
1100224411002200
0011111144110000
0011111144110011
0000221111110011
0000221111110011
0000111221000000
0000111221000000
3311114444444433
3311114444444433
4410220033334444
4410000033334444
4410000000000044
4410011111000044
2210011111000111
2210011611001111
