0000011001100033
3311011221101133
3311000220001133
3300000110000033
1101100110011011
1102200000011011
0000000000000000
1110111111101111
1010110000003001
1110001110003001
0010000001101001
1110111111101111
0000000000000000
0000011111000000
3330011111022333
3330011611022333