0000000000000000
0044002220044000
0044440004444000
0011111111122000
1111111111122111
0022000000011000
0022000221111000
0011110001111000
2022112200011002
2022000000011002
2011111111111002
0011111111111000
0011000000011000
0011011111012220
2211011111011111
0000011611000000