0000000000000003
1122111110000003
2200222211000003
2200222202220021
0000223302211110
0200223303300110
0200003303300110
2200003300200200
2200002220200200
2000002220011000
2440000011111000
2440000011111220
0440000000022220
0440011111022220
0110011111000000
2220011611000000