0022113300003333
0022113300003333
0011220033333320
0011220033333320
2222000002330000
2222000002330000
1133000022330000
1133000022330000
3311002222330000
3311002222330000
0000220000331111
0000220000331111
0110000000001111
0110011111001111
0110011111000001
0110011611000001