0000022022000000
0000022022000000
0011311311311000
0011311311311000
1311311311311311
1311311311311311
1311311311311311
1311311311311311
1311311311311311
1311311311311311
1311311311311311
1311322322311311
1311322322311311
1333311111333311
0000011111000000
0000011611000000