0000000000000000
1111111001111111
1111111111111111
1111111331111111
1111113333111111
1111133113311111
1111331111331111
1113311111133111
1133111111113311
1331111111111331
3111111111111113
1111111111111111
0000000000000000
2220011111000222
1110011111000111
1110011611000111