0000100000001111
0000100000001111
2222111112211000
2222111112211000
0022000333311111
0022000333333333
1111111111000001
1111111111000001
1111111112211002
0000000002211222
0033333333311110
0033333333311110
0033000000011333
1133011111011333
1100011111011113
1100011611011113