3300330004400000
3322330004400000
0222200111111111
0222200111111111
3322330104433331
3300330104433331
3300330104411111
3322330104411111
0222200104411333
0222200104411333
3322330104411111
3300330104411111
0000000000011111
0000011111011111
0220011111011000
0220011611011000