0000000000000000
4444000220004444
1333300110000111
1333300113333111
1110000003333000
1110000001100000
1110000333300000
1110000333322110
0002211110011110
0220000222200332
0002233222200332
0003333000000333
1110000000000222
1110011111001100
0200011111001100
0200011611001100