0000112221100333
0000112221100333
0000220000000333
0000220000000333
0000113331122113
0022113331122113
0022113330000000
2211113331100000
2211110001101221
1100110001144441
1100444441143331
1100112221143331
1100000000043341
1100011111043341
1100011111000001
1100011611000001