0000000000000000
3333300011111111
3333300000000011
3333311111110011
3333311111110011
3300001100000000
1111001100000000
2111002222220033
2111002222220033
1111000000003333
1120000011113333
1120000011114433
1120000000004433
1120011111003333
1111011111003333
1111021612001111