0000033331111111
1111133331100000
1111111001100444
1111111001100444
1111100000000000
1111100004444112
1111100004444112
1111111003311112
1111111003311112
1111111113311110
1111000003311110
1100111110033333
0011111110033333
0011011111033112
0000011111033112
0000011611000000