1100003333333333
1122111122222111
1122111100000111
1133111111111333
1133111111111333
3333333332200111
3333333332200111
4400444444444111
4400444444444111
0000000000000111
1110000011100111
0010221111100111
0010000000000111
0010011111011111
0010011111011111
0010011611000000