0011000000000000
0011002222221122
1111000000001122
1100111111111144
1100110001100044
2222000001100044
2222000003300044
0000333333333222
1111334444333000
0000334444333111
1111333333333111
1111443333344111
0000443333344111
0111011111044002
0111011111044002
0111011611000000