0000000000000000
0111101111011110
0100101001010010
0100101001010010
0111101111010010
0000100001010010
0111101111011110
0000000000000000
3333333333333322
3333333333333322
0011220000002200
0011002220002200
1100000000000022
1100011111000022
0011011111002200
0011011611002200