0000000000000000
3300011100003300
2300111111100330
0001111111111022
4011000000111100
0011020020110100
0111001100100000
0111111111100444
0011111111110000
1111111111111100
0001111111110000
0110011111001100
0011001110011000
0000000000000003
3300011211000033
2330011611000332
