0000220002200000
1333111111133311
1131110001113111
1111111111111111
1131110001113111
1333111111133311
1131110001113111
1111111111111111
1111110001111111
0000221112200000
0000220002200000
1110001110000111
0000000000000000
1110011111000111
0000011111000000
1110011611000111