0000000000110001
1111011110110001
1001010010110001
1111010010111001
0001010010111111
1111011110111111
0000000000111001
3333333322110001
3333333322110001
0000003333333333
2222003333333333
2000000000200002
0220000000020020
0220011111002200
0002011111002200
2222011611002200