0022330000002200
0022330000002200
3333220000000200
3333223333333333
3333333333333333
0111102001000111
0111102001000111
0000202001000100
0001202001000100
0011002221110100
0110002221110100
0111100001000111
0111100001000111
0000011111000000
0111011111011100
0111011611011100