0000033333333333
3333332222020010
3333332000020010
2111102000020010
1000102222020010
1000100002011111
1111100002000020
1000112222000020
1000133333333333
1111133333333333
3333333111101111
3333333011001100
0002000000001111
0002011111001100
0022011111001111
0000011611000000