0011111100440000
0011000000441111
0000001100000011
0000001100000022
0011111100000022
0011111100000011
0011112200000011
0011112200000022
0011111100220022
0011111100220011
0011111122221111
0011111122221111
0011000000000111
0011011111000011
0110011111000001
1000011611000000