1100330011002200
1100330011002200
0022001100110011
0022001100110011
1100110033004400
1100110033004400
0022003300110011
0022003300110011
1100110011001100
1100110011001100
3333332200110022
3333332200110022
3344000000001100
3344011111001100
3333011111110033
3333011611110033