0000000000000011
1111333333330011
1111333333330011
1133223333330044
1133223333330044
1133224422110044
1133224422110044
0033331111110000
0033331111110000
3333331100000000
3333331100112211
4444331100112211
4444330000111111
0000011111001111
0222011111001111
0000011611001111