4400000221100222
4400333221100222
0000111114403322
0000111114403300
0110333114403300
0110333114403322
0110111114400222
0440111114400222
4440333334403322
4440333334403300
0440111111100000
0440111111111000
0110000000011111
0110011111011111
1110011111000111
1110011611000011