0000001111113344
0000001111113344
1044441122223333
1044441100003333
0022201133001133
0022201133001133
0044111133003333
0044111133003333
0044333333004444
0044333333004444
0044000033111100
0044442233111100
0000000033110011
2211011111110011
2211011111112211
0011011611112211