0000000000000000
2200110011004114
2200110001004044
1100111100444000
1100000000401111
0000044440401111
0001044110000000
1110044000000200
0000044000002200
4440000022002000
0000011000002111
0000001111100000
1111000000110000
1110011111011100
1100011111001100
0000012621002200