0000001111221100
1122111111221100
1122114411001100
0000004411001100
1144004411331100
1144004411331100
1144004400001100
1144004400001100
1144001111111100
1144001111111100
1144004400000000
1144004400000000
0000000000033330
0000011111033330
2233011111000000
2233011611000000