0000000000000000
0000110220110000
0000110000110000
1122111111221111
1100001111000011
1100001111000000
1101331113310000
2211333333311122
0011003330011000
0011003330022000
0011000000022011
0000112221100011
3333000000003333
3333011111003333
3311011111001133
3322012621002233