0000000000000000
0222222222002200
0222000000000000
0000222233022000
0000222233022000
0002223300022200
0000220222222200
0000000222222000
0022200222222000
0022200222233000
0020000223300000
0022200330000000
0000200000000000
0000011111000022
0220011111000222
2220011611000000