0000000000000000
3333000220000110
3311000110000110
3311444444440044
1100110001100000
1100110001133222
0000222000333300
0000222022333330
4440444444440044
0000100000000000
3331100221110000
3301000221112211
3301000000010000
3301011111010010
3321011111000010
0000012621001110