0000000000000000
0033000000003300
3333000330333300
1111000333000000
0000000000000000
0044440003003333
0044440033000000
0000222111111111
0000222111111111
0000044444444331
1120000000000000
1120033332000000
0000033332002111
0000011111002111
3330011111044440
3330011611044440